1111111111111111111111111111111111
1000000000000000000000000000000001
1E0001110010100C00000C000001110001
1010010100000000101001000001000001
1010011110101010001001000001110101
1P0001001C111C000000000000000000C1
1111111111111111111111111111111111